oo_o____o_
_ooo____o_
___o____o_
__oo____o_
___oooo_o_
______o_o_
______o_o_
_oooooo_o_
_oo_____o_
__ooooooo_