oo_o______
_ooo______
___o______
__oo______
__________
__________
__________
__________
__________
__________